 #############################################################################################################
 #############################################################################################################
 ####S ##                      ##                  ##                                              ###########
 ####  ##  ##################  ##  ##########  ##  ##########  ##################################  ##  ##  ###
 ####  ##      ##  ##          ##  ##          ##              ##      ##                  ##  ##  ##  ##  ###
 ####  ######  ##  ##  ##############  ##########################  ######  ##########  ##  ##  ##  ##  ##  ###
 ####          ##  ##              ##  ##          ##      ##              ##          ##      ##  ##  ##  ###
 ################  ##############  ##  ##  ######  ##  ##  ######  ##########  ##############  ##  ######  ###
 ####              ##              ##          ##      ##      ##      ##      ##      ##      ##      ##  ###
 ####  ##############  ######################################  ##########  ######  ######  ##########  ##  ###
 ####                  ##      ##              ##              ##          ##      ##      ##          ##  ###
 ####  ##################  ##  ##  ##  ######  ##  ##############  ##########  ######  ######  ##########  ###
 ####              ##      ##  ##  ##  ##      ##  ##      ##      ##          ##          ##  ##      ##  ###
 ################  ######  ##  ##  ##  ##  ######  ##  ######  ##  ##########  ##  ##########  ##  ##  ##  ###
 ####  ##      ##          ##  ##  ##  ##          ##  ##      ##  ##      ##      ##  ##      ##  ##      ###
 ####  ##  ##  ##############  ######  ##############  ##  ######  ##  ##  ##  ######  ##  ######  ######  ###
 ####      ##              ##      ##  ##                  ##  ##      ##  ##          ##  ##      ##  ##  ###
 ####  ##############  ##########  ##  ##  ##################  ##########  ##########  ##  ##  ######  ##  ###
 ####  ##          ##  ##      ##  ##  ##                  ##      ##      ##      ##  ##  ##      ##  ##  ###
 ####  ##  ######  ##  ##  ##  ##  ##  ##################  ######  ##  ######  ##  ######  ######  ##  ##  ###
 ####      ##      ##      ##          ##                          ##          ##                  ##    E ###
 #############################################################################################################
 #############################################################################################################