################################
################################
################################
##S                 ############
####### ########### ############
####### ########### ############
####### ########### ############
#######             GFFFFFH#####
################### ############
########            ############
######## ########## ############
######## ####T##### ############
######## #### #####        E####
########      ##################
################################
################################
################################
################################
################################
################################